##########################
#.............#a........b#
#@.#.........a#..........#
####....########...#.....#
#b......###a.......#b....#
#.......########...###...#
#.a.....#a....###...b#..b#
#.......#.....###....#...#
#..b...a#b.........###...#
#.......#.....######...a.#
#.......#a.......##..#####
#.b.....#........##......#
#.a..............#####...#
#.....b...........b.##.c.#
##########################
