########################################
###................................#####
###..@.............................#####
###................................#####
###................................#####
###................................#####
###................................#####
###...........a....................#####
###................................#####
###................................#####
###................................#####
###................................#####
###................................#####
###................................#####
###................................#####
###................................#####
###................................#####
###................................#####
###................................#####
###................................#####
########################################