@#########
..#....###
#.#.##.###
#...#..###
#####.####
#####.....
##########