.....#......
....#.#.....
...#...#....
..#.....#...
.#...@...#..
..#.....#...
...#...#....
....#.#.....
.....#......
............